{
  "tiles" : [ [0, 0, 0, 0, 0, 0, 0, 0],
              [0, 0, 0, 0, 0, 0, 0, 0],
              [0, 0, 0, 0, 0, 0, 0, 0],
              [0, 0, 0, 0, 0, 0, 0, 0],
              [0, 0, 0, 0, 0, 0, 0, 0],
              [0, 0, 0, 0, 0, 0, 0, 0],
              [0, 0, 1, 2, 6, 11, 12, 0],
              [0, 0, 5, 1, 2, 6, 11, 0],
              [0, 0, 4, 5, 1, 2, 6, 0] ],
  "timeLimit" : 50,
}
